@  #     #
#  # #   #
#  #  #   
        # 
#  #  #   
## #  # # 
 #        
  ## ###  
 #     #  
          