###########
#@#    #  #
# ###  #  #
#      #  #
### #  #  #
# # ####  #
# #       #
#   # ##  #
###########